{
    "groundTextureUrl": "assets/ground.jpg",
    "wallTextureUrl": "assets/wall.jpg",
    "doorFrontTextureUrl": "assets/hospital-door-front.png",
    "doorBackTextureUrl": "assets/hospital-door-back.png",
    "bedModel" : "assets/hospital_bed.glb",
    "patientModel" : "assets/patient.glb",
    "nurseModel": "assets/nurse.glb",
    "size": { "width": 22, "height": 18},
    "layout": [
        [1,  1 ,  1 ,  1 , 1 ,  1 ,  1 ,  1 ,  1 ,  1 ,  1 ,  1 ,  1 ,  1 ,  1 ,  1 ,  1 ,  1 ,  1 ,  1 ,  1 ,  1 ,  1 ],
        [1, "A", "A", "A", 1 ,  0 ,  0 ,  1 ,  0 ,  0 ,  1 , "B", "B", "B", "B", "B", "B", "B", "B",  1 , "B", "B",  1 ],
        [1, "A", "A", "A", 1 ,  0 ,  0 ,  1 ,  0 ,  0 ,  1 , "B", "B", "B", "B", "B", "B", "B", "B", "B", "B", "B",  1 ],
        [1, "A", "A", "A", 1 ,  2 ,  1 ,  1 ,  0 ,  0 ,  1 , "B", "B", "B", "B", "B", "B", "B", "B",  1 ,  1 ,  1 ,  1 ],
        [1, "A", "A", "A", 1 ,  0 ,  2 ,  0 ,  0 ,  0 ,  1 , "B", "B", "B", "B", "B", "B", "B", "B",  1 , "C", "C",  1 ],
        [1, "A", "A", "A", 2 ,  0 ,  1 ,  1 ,  1 ,  1 ,  1 ,  2 ,  1 ,  1 ,  1 ,  1 ,  2 ,  2 ,  1 ,  1 ,  1 , "C",  1 ],
        [1, "A", "A", "A", 2 ,  0 ,  0 ,  0 ,  0 ,  0 ,  0 ,  0 ,  0 ,  0 ,  0 ,  0 ,  0 ,  0 ,  2 , "C", "C", "C",  1 ],
        [1,  1 ,  1 ,  1 , 1 ,  0 ,  1 ,  1 ,  2 ,  1 ,  1 ,  2 ,  1 ,  1 ,  2 ,  1 ,  1 ,  0 ,  2 , "C", "C", "C",  1 ],
        [1, "F", "F", "F", 2 ,  0 ,  1 ,  0 ,  0 ,  0 ,  1 ,  0 ,  0 ,  1 ,  0 ,  0 ,  1 ,  0 ,  1 , "C", "C", "C",  1 ],
        [1, "F", "F", "F", 1 ,  0 ,  1 ,  0 ,  0 ,  0 ,  1 ,  0 ,  0 ,  1 ,  0 ,  0 ,  1 ,  0 ,  1 , "C", "C", "C",  1 ],
        [1, "F", "F", "F", 1 ,  0 ,  1 ,  0 ,  0 ,  0 ,  1 ,  1 ,  1 ,  1 ,  1 ,  1 ,  1 ,  0 ,  1 , "C", "C", "C",  1 ],
        [1, "F", "F", "F", 1 ,  0 ,  1 ,  0 ,  0 ,  0 ,  1 ,  0 ,  2 ,  0 ,  2 ,  0 ,  1 ,  0 ,  1 ,  1 ,  1 ,  1 ,  1 ],
        [1, "F", "F", "F", 1 ,  0 ,  1 ,  0 ,  0 ,  0 ,  1 ,  1 ,  1 ,  0 ,  1 ,  1 ,  1 ,  0 ,  0 ,  2 ,  0 ,  0 ,  1 ],
        [1,  1 ,  1 ,  1 , 1 ,  0 ,  1 ,  1 ,  2 ,  1 ,  1 ,  0 ,  0 ,  0 ,  0 ,  0 ,  0 ,  0 ,  1 ,  1 ,  1 ,  1 ,  1 ],
        [1, "E", "E", "E", 2 ,  0 ,  0 ,  0 ,  0 ,  0 ,  0 ,  0 ,  0 ,  0 ,  0 ,  0 ,  0 ,  0 ,  1 , "D", "D", "D",  1 ],
        [1, "E", "E", "E", 1 ,  0 ,  0 ,  1 ,  2 ,  2 ,  1 ,  1 ,  1 ,  1 ,  2 ,  2 ,  1 ,  0 ,  1 , "D", "D", "D",  1 ],
        [1, "E", "E", "E", 1 ,  2 ,  1 ,  1 ,  0 ,  0 ,  0 ,  0 ,  0 ,  0 ,  0 ,  0 ,  1 ,  0 ,  1 , "D", "D", "D",  1 ],
        [1, "E", "E", "E", 1 ,  0 ,  0 ,  1 ,  0 ,  0 ,  0 ,  0 ,  0 ,  0 ,  0 ,  0 ,  1 ,  0 ,  2 , "D", "D", "D",  1 ],
        [1,  1 ,  1 ,  1 , 1 ,  1 ,  1 ,  1 ,  1 ,  1 ,  1 ,  2 ,  2 ,  1 ,  1 ,  1 ,  1 ,  1 ,  1 ,  1 ,  1 ,  1 ,  1 ]
    ],
    "entrance": [17, 10],
    "rooms": [
    { "id": "A", "table": [[3, 2, 2]] },
    { "id": "B", "table": [[2, 15, 1]] },
    { "id": "C", "table": [[9, 20, 2]] },
    { "id": "D", "table": [[15, 20, 2]] },
    { "id": "E", "table": [[16, 2, 2]] },
    { "id": "F", "table": [[11, 2, 2]] }
  ]
}